Java	Java Swing, Java EE, Spring, Hibernate, eBean, Micronaut
Python	---
Python 3 ---
Web	PHP, HTML, HTML 5, CSS, JavaScript, ECMAScript
XML	XML, XHTML, XSLT
COBOL	---
FORTRAN	---
Rust	---
SmallTalk	---
C / C++	---
Objective C	---
Bases de données	NoSQL, Base de données relationnelle, indexation, Entrepôt de données, Data Lake
Shell	Bash, ksh, PowerShell
Systèmes d'exploitation	Windows, Unix, Linux, Mac OS X, Androis, iOS
Apache	Serveur Web Apache
Big Data	Apacxhe Kafka, Apache Solr
Tests Unitaires	Selenium, JUnit
Reverse Ingeniering	Ingénierie Inverse
Documentation	Javadoc, Pythondoc, Doxygen
Conception	UML, MERISE, Analyse Fonctionnelle
Développement logiciel	Cycle en V, Agile, Scrum, Kanban
Modèles de développement	Modèle MVC, Cycle en V
Outils	WebScrapping, Machine Learning, Intelligence Artificielle 